province;agegrp5;sex;no_reinf;reinf;total
EASTERN CAPE;(0,5];F;1597;6;1603
EASTERN CAPE;(0,5];M;1654;3;1657
EASTERN CAPE;(0,5];U;140;0;140
EASTERN CAPE;(10,15];F;7753;55;7808
EASTERN CAPE;(10,15];M;6280;35;6315
EASTERN CAPE;(10,15];U;595;2;597
EASTERN CAPE;(15,20];F;10550;87;10637
EASTERN CAPE;(15,20];M;7814;58;7872
EASTERN CAPE;(15,20];U;456;0;456
EASTERN CAPE;(20,25];F;10060;143;10203
EASTERN CAPE;(20,25];M;6742;78;6820
EASTERN CAPE;(20,25];U;205;0;205
EASTERN CAPE;(25,30];F;13597;260;13857
EASTERN CAPE;(25,30];M;8870;132;9002
EASTERN CAPE;(25,30];U;191;0;191
EASTERN CAPE;(30,35];F;15146;271;15417
EASTERN CAPE;(30,35];M;9882;139;10021
EASTERN CAPE;(30,35];U;185;1;186
EASTERN CAPE;(35,40];F;15507;263;15770
EASTERN CAPE;(35,40];M;10198;137;10335
EASTERN CAPE;(35,40];U;171;0;171
EASTERN CAPE;(40,45];F;14127;165;14292
EASTERN CAPE;(40,45];M;9338;120;9458
EASTERN CAPE;(40,45];U;149;1;150
EASTERN CAPE;(45,50];F;14288;189;14477
EASTERN CAPE;(45,50];M;9364;118;9482
EASTERN CAPE;(45,50];U;148;0;148
EASTERN CAPE;(5,10];F;3764;11;3775
EASTERN CAPE;(5,10];M;3505;9;3514
EASTERN CAPE;(5,10];U;320;0;320
EASTERN CAPE;(50,55];F;13232;136;13368
EASTERN CAPE;(50,55];M;8734;85;8819
EASTERN CAPE;(50,55];U;137;0;137
EASTERN CAPE;(55,60];F;11869;99;11968
EASTERN CAPE;(55,60];M;7575;65;7640
EASTERN CAPE;(55,60];U;133;0;133
EASTERN CAPE;(60,65];F;8126;41;8167
EASTERN CAPE;(60,65];M;5866;34;5900
EASTERN CAPE;(60,65];U;123;0;123
EASTERN CAPE;(65,70];F;5709;20;5729
EASTERN CAPE;(65,70];M;4218;17;4235
EASTERN CAPE;(65,70];U;79;0;79
EASTERN CAPE;(70,75];F;3961;14;3975
EASTERN CAPE;(70,75];M;2836;12;2848
EASTERN CAPE;(70,75];U;72;0;72
EASTERN CAPE;(75,80];F;2770;14;2784
EASTERN CAPE;(75,80];M;1860;10;1870
EASTERN CAPE;(75,80];U;46;0;46
EASTERN CAPE;(80,130];F;3278;16;3294
EASTERN CAPE;(80,130];M;1586;6;1592
EASTERN CAPE;(80,130];U;52;0;52
FREE STATE;(0,5];F;962;1;963
FREE STATE;(0,5];M;997;6;1003
FREE STATE;(0,5];U;31;0;31
FREE STATE;(10,15];F;3834;36;3870
FREE STATE;(10,15];M;3309;24;3333
FREE STATE;(10,15];U;112;0;112
FREE STATE;(15,20];F;6012;68;6080
FREE STATE;(15,20];M;4038;47;4085
FREE STATE;(15,20];U;114;1;115
FREE STATE;(20,25];F;5622;88;5710
FREE STATE;(20,25];M;3674;57;3731
FREE STATE;(20,25];U;75;0;75
FREE STATE;(25,30];F;7913;133;8046
FREE STATE;(25,30];M;5150;74;5224
FREE STATE;(25,30];U;76;0;76
FREE STATE;(30,35];F;9063;127;9190
FREE STATE;(30,35];M;6082;101;6183
FREE STATE;(30,35];U;82;0;82
FREE STATE;(35,40];F;8857;123;8980
FREE STATE;(35,40];M;6297;100;6397
FREE STATE;(35,40];U;76;0;76
FREE STATE;(40,45];F;7718;107;7825
FREE STATE;(40,45];M;5525;88;5613
FREE STATE;(40,45];U;57;1;58
FREE STATE;(45,50];F;7593;87;7680
FREE STATE;(45,50];M;5659;76;5735
FREE STATE;(45,50];U;63;0;63
FREE STATE;(5,10];F;1928;4;1932
FREE STATE;(5,10];M;1761;4;1765
FREE STATE;(5,10];U;69;0;69
FREE STATE;(50,55];F;7130;76;7206
FREE STATE;(50,55];M;5282;79;5361
FREE STATE;(50,55];U;61;0;61
FREE STATE;(55,60];F;6158;71;6229
FREE STATE;(55,60];M;4307;49;4356
FREE STATE;(55,60];U;56;0;56
FREE STATE;(60,65];F;4098;23;4121
FREE STATE;(60,65];M;3033;30;3063
FREE STATE;(60,65];U;37;0;37
FREE STATE;(65,70];F;3015;17;3032
FREE STATE;(65,70];M;2146;20;2166
FREE STATE;(65,70];U;33;0;33
FREE STATE;(70,75];F;2274;17;2291
FREE STATE;(70,75];M;1522;20;1542
FREE STATE;(70,75];U;23;0;23
FREE STATE;(75,80];F;1638;7;1645
FREE STATE;(75,80];M;969;10;979
FREE STATE;(75,80];U;26;0;26
FREE STATE;(80,130];F;1892;14;1906
FREE STATE;(80,130];M;814;5;819
FREE STATE;(80,130];U;20;0;20
GAUTENG;(0,5];F;5205;20;5225
GAUTENG;(0,5];M;5570;17;5587
GAUTENG;(0,5];U;142;1;143
GAUTENG;(10,15];F;14386;83;14469
GAUTENG;(10,15];M;12852;60;12912
GAUTENG;(10,15];U;353;0;353
GAUTENG;(15,20];F;23874;271;24145
GAUTENG;(15,20];M;18512;185;18697
GAUTENG;(15,20];U;365;0;365
GAUTENG;(20,25];F;34919;581;35500
GAUTENG;(20,25];M;25419;385;25804
GAUTENG;(20,25];U;434;1;435
GAUTENG;(25,30];F;55156;1043;56199
GAUTENG;(25,30];M;38761;600;39361
GAUTENG;(25,30];U;623;1;624
GAUTENG;(30,35];F;62254;1151;63405
GAUTENG;(30,35];M;45946;722;46668
GAUTENG;(30,35];U;632;4;636
GAUTENG;(35,40];F;60276;999;61275
GAUTENG;(35,40];M;47675;734;48409
GAUTENG;(35,40];U;620;2;622
GAUTENG;(40,45];F;50024;733;50757
GAUTENG;(40,45];M;41969;581;42550
GAUTENG;(40,45];U;500;1;501
GAUTENG;(45,50];F;46673;670;47343
GAUTENG;(45,50];M;40097;555;40652
GAUTENG;(45,50];U;403;3;406
GAUTENG;(5,10];F;7625;27;7652
GAUTENG;(5,10];M;7736;24;7760
GAUTENG;(5,10];U;180;0;180
GAUTENG;(50,55];F;40731;500;41231
GAUTENG;(50,55];M;34473;416;34889
GAUTENG;(50,55];U;333;0;333
GAUTENG;(55,60];F;31641;341;31982
GAUTENG;(55,60];M;26547;272;26819
GAUTENG;(55,60];U;316;0;316
GAUTENG;(60,65];F;20749;160;20909
GAUTENG;(60,65];M;17462;148;17610
GAUTENG;(60,65];U;187;0;187
GAUTENG;(65,70];F;13837;103;13940
GAUTENG;(65,70];M;11719;89;11808
GAUTENG;(65,70];U;131;0;131
GAUTENG;(70,75];F;9959;61;10020
GAUTENG;(70,75];M;8194;54;8248
GAUTENG;(70,75];U;75;0;75
GAUTENG;(75,80];F;6875;33;6908
GAUTENG;(75,80];M;5148;24;5172
GAUTENG;(75,80];U;41;0;41
GAUTENG;(80,130];F;8088;55;8143
GAUTENG;(80,130];M;4482;28;4510
GAUTENG;(80,130];U;65;1;66
KWAZULU-NATAL;(0,5];F;4431;14;4445
KWAZULU-NATAL;(0,5];M;4476;13;4489
KWAZULU-NATAL;(0,5];U;372;0;372
KWAZULU-NATAL;(10,15];F;12828;87;12915
KWAZULU-NATAL;(10,15];M;10544;58;10602
KWAZULU-NATAL;(10,15];U;882;2;884
KWAZULU-NATAL;(15,20];F;18245;170;18415
KWAZULU-NATAL;(15,20];M;12315;87;12402
KWAZULU-NATAL;(15,20];U;946;2;948
KWAZULU-NATAL;(20,25];F;20148;247;20395
KWAZULU-NATAL;(20,25];M;13398;179;13577
KWAZULU-NATAL;(20,25];U;889;1;890
KWAZULU-NATAL;(25,30];F;26870;490;27360
KWAZULU-NATAL;(25,30];M;17496;281;17777
KWAZULU-NATAL;(25,30];U;986;1;987
KWAZULU-NATAL;(30,35];F;29653;527;30180
KWAZULU-NATAL;(30,35];M;19160;311;19471
KWAZULU-NATAL;(30,35];U;1035;4;1039
KWAZULU-NATAL;(35,40];F;28061;442;28503
KWAZULU-NATAL;(35,40];M;19380;249;19629
KWAZULU-NATAL;(35,40];U;919;0;919
KWAZULU-NATAL;(40,45];F;24230;376;24606
KWAZULU-NATAL;(40,45];M;17276;197;17473
KWAZULU-NATAL;(40,45];U;772;0;772
KWAZULU-NATAL;(45,50];F;23047;272;23319
KWAZULU-NATAL;(45,50];M;16444;176;16620
KWAZULU-NATAL;(45,50];U;755;2;757
KWAZULU-NATAL;(5,10];F;7309;24;7333
KWAZULU-NATAL;(5,10];M;6722;30;6752
KWAZULU-NATAL;(5,10];U;638;0;638
KWAZULU-NATAL;(50,55];F;21147;236;21383
KWAZULU-NATAL;(50,55];M;14269;153;14422
KWAZULU-NATAL;(50,55];U;662;1;663
KWAZULU-NATAL;(55,60];F;17863;150;18013
KWAZULU-NATAL;(55,60];M;12460;111;12571
KWAZULU-NATAL;(55,60];U;649;0;649
KWAZULU-NATAL;(60,65];F;11901;72;11973
KWAZULU-NATAL;(60,65];M;8699;56;8755
KWAZULU-NATAL;(60,65];U;466;0;466
KWAZULU-NATAL;(65,70];F;8782;53;8835
KWAZULU-NATAL;(65,70];M;6331;41;6372
KWAZULU-NATAL;(65,70];U;398;0;398
KWAZULU-NATAL;(70,75];F;6338;31;6369
KWAZULU-NATAL;(70,75];M;4290;35;4325
KWAZULU-NATAL;(70,75];U;296;0;296
KWAZULU-NATAL;(75,80];F;4329;20;4349
KWAZULU-NATAL;(75,80];M;2444;12;2456
KWAZULU-NATAL;(75,80];U;180;0;180
KWAZULU-NATAL;(80,130];F;4652;20;4672
KWAZULU-NATAL;(80,130];M;2056;8;2064
KWAZULU-NATAL;(80,130];U;195;0;195
LIMPOPO;(0,5];F;713;2;715
LIMPOPO;(0,5];M;785;4;789
LIMPOPO;(0,5];U;24;0;24
LIMPOPO;(10,15];F;1944;3;1947
LIMPOPO;(10,15];M;1608;9;1617
LIMPOPO;(10,15];U;49;0;49
LIMPOPO;(15,20];F;3300;20;3320
LIMPOPO;(15,20];M;2506;12;2518
LIMPOPO;(15,20];U;73;0;73
LIMPOPO;(20,25];F;3777;56;3833
LIMPOPO;(20,25];M;2685;28;2713
LIMPOPO;(20,25];U;39;0;39
LIMPOPO;(25,30];F;6499;73;6572
LIMPOPO;(25,30];M;4745;97;4842
LIMPOPO;(25,30];U;45;1;46
LIMPOPO;(30,35];F;7929;120;8049
LIMPOPO;(30,35];M;6090;80;6170
LIMPOPO;(30,35];U;58;1;59
LIMPOPO;(35,40];F;7875;96;7971
LIMPOPO;(35,40];M;6293;80;6373
LIMPOPO;(35,40];U;68;0;68
LIMPOPO;(40,45];F;6817;73;6890
LIMPOPO;(40,45];M;5409;60;5469
LIMPOPO;(40,45];U;58;1;59
LIMPOPO;(45,50];F;6753;79;6832
LIMPOPO;(45,50];M;5193;50;5243
LIMPOPO;(45,50];U;56;2;58
LIMPOPO;(5,10];F;999;2;1001
LIMPOPO;(5,10];M;994;3;997
LIMPOPO;(5,10];U;26;0;26
LIMPOPO;(50,55];F;6118;42;6160
LIMPOPO;(50,55];M;5112;57;5169
LIMPOPO;(50,55];U;48;0;48
LIMPOPO;(55,60];F;4880;36;4916
LIMPOPO;(55,60];M;4267;31;4298
LIMPOPO;(55,60];U;33;0;33
LIMPOPO;(60,65];F;2807;10;2817
LIMPOPO;(60,65];M;2589;11;2600
LIMPOPO;(60,65];U;15;1;16
LIMPOPO;(65,70];F;1809;5;1814
LIMPOPO;(65,70];M;1860;5;1865
LIMPOPO;(65,70];U;17;0;17
LIMPOPO;(70,75];F;1174;6;1180
LIMPOPO;(70,75];M;1191;6;1197
LIMPOPO;(70,75];U;12;0;12
LIMPOPO;(75,80];F;907;3;910
LIMPOPO;(75,80];M;701;0;701
LIMPOPO;(75,80];U;5;0;5
LIMPOPO;(80,130];F;1157;0;1157
LIMPOPO;(80,130];M;547;0;547
LIMPOPO;(80,130];U;10;0;10
MPUMALANGA;(0,5];F;958;11;969
MPUMALANGA;(0,5];M;1041;14;1055
MPUMALANGA;(0,5];U;39;0;39
MPUMALANGA;(10,15];F;2773;33;2806
MPUMALANGA;(10,15];M;2431;27;2458
MPUMALANGA;(10,15];U;74;0;74
MPUMALANGA;(15,20];F;4598;61;4659
MPUMALANGA;(15,20];M;3183;33;3216
MPUMALANGA;(15,20];U;102;1;103
MPUMALANGA;(20,25];F;5288;63;5351
MPUMALANGA;(20,25];M;3705;43;3748
MPUMALANGA;(20,25];U;68;0;68
MPUMALANGA;(25,30];F;8479;149;8628
MPUMALANGA;(25,30];M;5949;102;6051
MPUMALANGA;(25,30];U;123;0;123
MPUMALANGA;(30,35];F;9647;166;9813
MPUMALANGA;(30,35];M;7541;118;7659
MPUMALANGA;(30,35];U;109;0;109
MPUMALANGA;(35,40];F;9315;146;9461
MPUMALANGA;(35,40];M;7619;123;7742
MPUMALANGA;(35,40];U;81;0;81
MPUMALANGA;(40,45];F;7523;118;7641
MPUMALANGA;(40,45];M;6309;93;6402
MPUMALANGA;(40,45];U;61;0;61
MPUMALANGA;(45,50];F;7056;95;7151
MPUMALANGA;(45,50];M;5882;82;5964
MPUMALANGA;(45,50];U;67;1;68
MPUMALANGA;(5,10];F;1442;22;1464
MPUMALANGA;(5,10];M;1379;13;1392
MPUMALANGA;(5,10];U;47;0;47
MPUMALANGA;(50,55];F;6483;71;6554
MPUMALANGA;(50,55];M;5075;58;5133
MPUMALANGA;(50,55];U;40;0;40
MPUMALANGA;(55,60];F;5166;41;5207
MPUMALANGA;(55,60];M;4470;51;4521
MPUMALANGA;(55,60];U;47;1;48
MPUMALANGA;(60,65];F;3292;20;3312
MPUMALANGA;(60,65];M;2967;25;2992
MPUMALANGA;(60,65];U;29;0;29
MPUMALANGA;(65,70];F;2261;11;2272
MPUMALANGA;(65,70];M;1964;17;1981
MPUMALANGA;(65,70];U;16;0;16
MPUMALANGA;(70,75];F;1389;9;1398
MPUMALANGA;(70,75];M;1267;12;1279
MPUMALANGA;(70,75];U;17;0;17
MPUMALANGA;(75,80];F;968;8;976
MPUMALANGA;(75,80];M;693;6;699
MPUMALANGA;(75,80];U;7;0;7
MPUMALANGA;(80,130];F;1104;6;1110
MPUMALANGA;(80,130];M;605;1;606
MPUMALANGA;(80,130];U;14;0;14
NORTH WEST;(0,5];F;784;9;793
NORTH WEST;(0,5];M;884;9;893
NORTH WEST;(0,5];U;33;0;33
NORTH WEST;(10,15];F;3101;30;3131
NORTH WEST;(10,15];M;2462;28;2490
NORTH WEST;(10,15];U;108;1;109
NORTH WEST;(15,20];F;4915;43;4958
NORTH WEST;(15,20];M;3312;30;3342
NORTH WEST;(15,20];U;102;0;102
NORTH WEST;(20,25];F;5007;76;5083
NORTH WEST;(20,25];M;3721;59;3780
NORTH WEST;(20,25];U;94;1;95
NORTH WEST;(25,30];F;7421;142;7563
NORTH WEST;(25,30];M;5554;92;5646
NORTH WEST;(25,30];U;111;0;111
NORTH WEST;(30,35];F;8438;161;8599
NORTH WEST;(30,35];M;6974;125;7099
NORTH WEST;(30,35];U;112;0;112
NORTH WEST;(35,40];F;8462;112;8574
NORTH WEST;(35,40];M;7754;147;7901
NORTH WEST;(35,40];U;112;1;113
NORTH WEST;(40,45];F;7400;135;7535
NORTH WEST;(40,45];M;7257;103;7360
NORTH WEST;(40,45];U;82;0;82
NORTH WEST;(45,50];F;7010;112;7122
NORTH WEST;(45,50];M;6777;86;6863
NORTH WEST;(45,50];U;67;0;67
NORTH WEST;(5,10];F;1445;10;1455
NORTH WEST;(5,10];M;1397;17;1414
NORTH WEST;(5,10];U;59;0;59
NORTH WEST;(50,55];F;6406;69;6475
NORTH WEST;(50,55];M;6213;83;6296
NORTH WEST;(50,55];U;68;1;69
NORTH WEST;(55,60];F;5176;44;5220
NORTH WEST;(55,60];M;4976;47;5023
NORTH WEST;(55,60];U;59;0;59
NORTH WEST;(60,65];F;3442;20;3462
NORTH WEST;(60,65];M;2783;23;2806
NORTH WEST;(60,65];U;37;0;37
NORTH WEST;(65,70];F;2445;14;2459
NORTH WEST;(65,70];M;1969;10;1979
NORTH WEST;(65,70];U;21;0;21
NORTH WEST;(70,75];F;1580;7;1587
NORTH WEST;(70,75];M;1335;8;1343
NORTH WEST;(70,75];U;17;0;17
NORTH WEST;(75,80];F;1104;6;1110
NORTH WEST;(75,80];M;803;5;808
NORTH WEST;(75,80];U;24;0;24
NORTH WEST;(80,130];F;1230;9;1239
NORTH WEST;(80,130];M;744;1;745
NORTH WEST;(80,130];U;16;0;16
NORTHERN CAPE;(0,5];F;624;4;628
NORTHERN CAPE;(0,5];M;668;4;672
NORTHERN CAPE;(0,5];U;37;0;37
NORTHERN CAPE;(10,15];F;2787;24;2811
NORTHERN CAPE;(10,15];M;2334;8;2342
NORTHERN CAPE;(10,15];U;207;0;207
NORTHERN CAPE;(15,20];F;3435;30;3465
NORTHERN CAPE;(15,20];M;2372;25;2397
NORTHERN CAPE;(15,20];U;140;0;140
NORTHERN CAPE;(20,25];F;3206;53;3259
NORTHERN CAPE;(20,25];M;2248;23;2271
NORTHERN CAPE;(20,25];U;79;0;79
NORTHERN CAPE;(25,30];F;4258;70;4328
NORTHERN CAPE;(25,30];M;2901;46;2947
NORTHERN CAPE;(25,30];U;89;0;89
NORTHERN CAPE;(30,35];F;4501;67;4568
NORTHERN CAPE;(30,35];M;3119;49;3168
NORTHERN CAPE;(30,35];U;91;0;91
NORTHERN CAPE;(35,40];F;4609;72;4681
NORTHERN CAPE;(35,40];M;3578;49;3627
NORTHERN CAPE;(35,40];U;101;0;101
NORTHERN CAPE;(40,45];F;3867;56;3923
NORTHERN CAPE;(40,45];M;3139;49;3188
NORTHERN CAPE;(40,45];U;59;0;59
NORTHERN CAPE;(45,50];F;3752;47;3799
NORTHERN CAPE;(45,50];M;2858;33;2891
NORTHERN CAPE;(45,50];U;62;0;62
NORTHERN CAPE;(5,10];F;1510;15;1525
NORTHERN CAPE;(5,10];M;1555;5;1560
NORTHERN CAPE;(5,10];U;116;0;116
NORTHERN CAPE;(50,55];F;3597;39;3636
NORTHERN CAPE;(50,55];M;2756;41;2797
NORTHERN CAPE;(50,55];U;55;0;55
NORTHERN CAPE;(55,60];F;2838;28;2866
NORTHERN CAPE;(55,60];M;2104;21;2125
NORTHERN CAPE;(55,60];U;56;0;56
NORTHERN CAPE;(60,65];F;2053;20;2073
NORTHERN CAPE;(60,65];M;1467;14;1481
NORTHERN CAPE;(60,65];U;34;0;34
NORTHERN CAPE;(65,70];F;1458;9;1467
NORTHERN CAPE;(65,70];M;1051;14;1065
NORTHERN CAPE;(65,70];U;31;0;31
NORTHERN CAPE;(70,75];F;1063;7;1070
NORTHERN CAPE;(70,75];M;720;8;728
NORTHERN CAPE;(70,75];U;18;0;18
NORTHERN CAPE;(75,80];F;701;5;706
NORTHERN CAPE;(75,80];M;450;4;454
NORTHERN CAPE;(75,80];U;10;0;10
NORTHERN CAPE;(80,130];F;844;11;855
NORTHERN CAPE;(80,130];M;432;1;433
NORTHERN CAPE;(80,130];U;15;0;15
WESTERN CAPE;(0,5];F;1868;16;1884
WESTERN CAPE;(0,5];M;2141;22;2163
WESTERN CAPE;(0,5];U;21;0;21
WESTERN CAPE;(10,15];F;6204;63;6267
WESTERN CAPE;(10,15];M;5469;43;5512
WESTERN CAPE;(10,15];U;111;0;111
WESTERN CAPE;(15,20];F;11864;183;12047
WESTERN CAPE;(15,20];M;9564;146;9710
WESTERN CAPE;(15,20];U;136;0;136
WESTERN CAPE;(20,25];F;20826;449;21275
WESTERN CAPE;(20,25];M;15659;273;15932
WESTERN CAPE;(20,25];U;238;0;238
WESTERN CAPE;(25,30];F;28176;676;28852
WESTERN CAPE;(25,30];M;20513;441;20954
WESTERN CAPE;(25,30];U;297;2;299
WESTERN CAPE;(30,35];F;29823;729;30552
WESTERN CAPE;(30,35];M;22678;412;23090
WESTERN CAPE;(30,35];U;293;0;293
WESTERN CAPE;(35,40];F;29146;666;29812
WESTERN CAPE;(35,40];M;22702;442;23144
WESTERN CAPE;(35,40];U;247;0;247
WESTERN CAPE;(40,45];F;24930;515;25445
WESTERN CAPE;(40,45];M;20620;342;20962
WESTERN CAPE;(40,45];U;243;0;243
WESTERN CAPE;(45,50];F;25715;435;26150
WESTERN CAPE;(45,50];M;21770;349;22119
WESTERN CAPE;(45,50];U;207;1;208
WESTERN CAPE;(5,10];F;2711;13;2724
WESTERN CAPE;(5,10];M;2808;19;2827
WESTERN CAPE;(5,10];U;39;0;39
WESTERN CAPE;(50,55];F;23595;384;23979
WESTERN CAPE;(50,55];M;19524;280;19804
WESTERN CAPE;(50,55];U;176;0;176
WESTERN CAPE;(55,60];F;19360;267;19627
WESTERN CAPE;(55,60];M;16243;205;16448
WESTERN CAPE;(55,60];U;172;1;173
WESTERN CAPE;(60,65];F;13223;153;13376
WESTERN CAPE;(60,65];M;11125;132;11257
WESTERN CAPE;(60,65];U;90;1;91
WESTERN CAPE;(65,70];F;9448;108;9556
WESTERN CAPE;(65,70];M;7911;92;8003
WESTERN CAPE;(65,70];U;59;0;59
WESTERN CAPE;(70,75];F;6659;63;6722
WESTERN CAPE;(70,75];M;5367;50;5417
WESTERN CAPE;(70,75];U;34;0;34
WESTERN CAPE;(75,80];F;4580;50;4630
WESTERN CAPE;(75,80];M;3356;40;3396
WESTERN CAPE;(75,80];U;21;0;21
WESTERN CAPE;(80,130];F;6071;70;6141
WESTERN CAPE;(80,130];M;3225;41;3266
WESTERN CAPE;(80,130];U;24;0;24
